S ./textures/greenlight.xpm
	R 500 400

           SO ./textures/bluestone.xpm
	NO ./textures/redbrick.xpm
WE ./textures/colorstone.xpm
EA 	./textures/greystone.xpm


		F	 0, 0, 30		
   C 			  			255, 100, 0
  
		
        1111111111111111111111111
        1000000000000000000000021
        1200000000000001111111111
        1000200000000001
111111111000000000000001
10000000000000000000000111111
11111111111111110000000000001
1S000000000000001000000000001
10000111111111110000000000001
10200000000000000000000000001
10000000000000011111100000001
1001111111000001    100000011
10000021 1000001    100000001
11111111 1111111    111111111
