S ./textures/greenlight.xpm
	R 500 400

           SO ./textures/bluestone.xpm
	NO ./textures/redbrick.xpm
WE ./textures/colorstone.xpm
EA 	./textures/greystone.xpm


		F	 0, 0, 30		
   C 			  			255, 100, 0
  
		

 
        1111111111 11111111111111111111
        1000000001 10000000000000000001
        1011000111 10000000000000000111
        10010001111100000000000000001 1
111111111011000001110000000000000000111
100000000011000001110111111111111111111
111101111111110111000000000000000000111
1111011111111101110101001000000000001
1122000211012101110000001000000000001
1000000000222001110000001000000000001
1000200000000000000000000000000000001
1100000111110101111111000000000000001
11110111 111N101 1 111101000000000001
11111111 1111111 11111111111111111111
